R 900 500

NO ./textures/wood.xpm
SO ./textures/redbrick.xpm
WE ./textures/stone.xpm
EA ./textures/mossy.xpm

S ./textures/hitler.xpm
F 220,000,700
111111111111111111111111111111111111111111111111
100000000000000000000001000000000000000000000001
10000000000000000000000100000000N000000000000001
100000000000000000000001000000000000000000000001
100000111110000101010001000000000000000000000001
100000100010000000000001000000000000000000000001
100000100010000100010000000000000000002000000001
100000110110000111110000000000000000000000000001
100000000000000000000001111111111111111111111101
100000000000000000000001000000000000000000000001
111111111111111111111111111111111111111111111111