11111111111111111111111111111
10000000001100000000000000001
10110000011100000010000010001
100100000000000S0000000010001
10110000011100000000000010001
10000000001100000111011110001
11110111111111011100000010001
11110111111111011101010010001
11000000110101011100000010001
10001000000000001100000010001
10000000000000001101010010001
11000000110101011111011110001
11111011111101011111011110001
11111111111111111111111111111
