R 1080 720

EA ./textures/mossy.xpm
NO ./textures/redbrick.xpm
SO ./textures/wood.xpm
WE ./textures/stone.xpm

T  ./sprites/barrel.xpm

F 84,78,76
C 26,5,30


111111111111111111111111
100000000000000100000001
100000011111111111011111
100000010101010110001111
100000000000000110000001
1002000000W0000000001111
100000000000001100000001
000000010000000110001111
100000011110111111111111
111111111130311111111111
100000000000000000001001
111111011110111111111111
111111011110111111111111
100000000110110000010001
100020000000110010010001
100000000110110000011011
101010000110000010000001
100100000110110000011011
101010000110110010010001
100000000110110000010001
111111111111111111111111
 