R 1080 720

NO ./path_to_the_north_texture
SO ./textures/mossy.xpm
WE ./path_to_the_west_texture
EA ./textures/mossy.xpm

111111111111111111111111
100000000000000010000001
101000000000000000000001
101000000000000000000001
101000000000000010000001
101000011111111111011111
101000010101010110001111
101000010000000110000001
1000000000W0000000001111
101000010000000110004001
100000010000000110001111
100000011110111111111111
111111111130311111111111
100000000000000000001001
111111011110111111111111
111111011110111111111111
100000000110110000010001
100000000000110010010001
100000000110110000011011
101010000110000010000001
100100000110110000011011
101010000110110010010001
100000000110110000010001
111111111111111111111111
