R 1080 720

EA ./textures/mossy.xpm
NO ./textures/mossy.xpm
SO ./textures/wood.xpm
WE ./textures/stone.xpm

F 84,78,76
C 26,5,30


        1111111111111111111111111
        1000000000110000000000001
        1011000001110000002000001
        1001000000000000000000001
111111111011000001110000000000001
100000000011000001110111111111111
11110111111111011100000000001
11110111111111011101010000001
11000000110101011100000010001
10002000000000001100000010001
10000000000000001101010010001
10000001110101011111011110N01
11110111 1110101 101111010001
11111111 1111111 111111111111
