1 1 1 1 1
1 0 1 0 1
1 0 1 1 1
1 0 0 W 1
1 1 1 1 1
